
















G                                      G
D                                      D
D  S   D   G   W   T                   D
D                                      D
D                                      D
D                                      D
DE                                     D
DGGGGGGGGGGGGGGGGGGGGGGGGGGGGGGGGGGGGGGD
