
















G                                      G
D                                      D
D  S   D   G                           D
D                                      D
D                                      D
D                                      D
DE                                     D
DGGGGGGGGGGGGGGGGGGGGGGGGGGGGGGGGGGGGGGD
