
















G                                      G
D                                      D
D  S   D   G   W                       D
D                                      D
D                                      D
D                                      D
DE                                     D
DGGGGGGGGGGGGGGGGGGGGGGGGGGGGGGGGGGGGGGD
